...................................................................................................................................................#......
...................................................................................................................................................#......
...................................................................................................................................................#......
...................................................................................................................................................#......
............................................................................................5......................................................#......
.......................................................................................................................6..............E............#......
..#.B..........B............................P......................4.........................................................H.....................#......
.##........................................................1...................2........................3..........................................#......
##########################################################################################################################################################